6
6
#####
#@ ##
#.$  #
#   ##
#    #
######
