7
7
  ####
###  #
#@ . ##
#   $ #
# #   #
#     #
#######
