7
8
#######
# ..$ #
# # $ #
# # # #
# $@# #
#.$   #
#.#####
###